64 16
2 0 ,2 0 ,2 0 ,2 0 ,2 0 ,2 0 ,2 0 ,2 0 ,2 0 ,2 0 ,2 0 ,2 0 ,2 0 ,2 0 ,21 0 ,21 0 ,16 0 ,16 0 ,16 0 ,16 0 ,16 0 ,16 0 ,16 0 ,16 0 ,16 0 ,16 0 ,16 0 ,7 0 ,8 0 ,8 0 ,9 0 ,16 0 ,16 0 ,16 0 ,16 0 ,16 0 ,16 0 ,16 0 ,16 0 ,16 0 ,16 0 ,16 0 ,0 0 ,0 0 ,0 0 ,0 0 ,0 0 ,0 0 ,0 0 ,0 0 ,0 0 ,0 0 ,0 0 ,0 0 ,0 0 ,0 0 ,0 0 ,0 0 ,0 0 ,0 0 ,0 0 ,0 0 ,0 0 ,0 0 ,
2 0 ,2 0 ,2 0 ,2 0 ,2 0 ,2 0 ,2 0 ,2 0 ,2 0 ,2 0 ,2 0 ,2 0 ,2 0 ,2 0 ,21 0 ,21 0 ,16 0 ,16 0 ,16 0 ,16 0 ,16 0 ,16 0 ,16 0 ,16 0 ,16 0 ,16 0 ,16 0 ,23 0 ,24 0 ,24 0 ,25 0 ,16 0 ,16 0 ,16 0 ,16 0 ,16 0 ,16 0 ,16 0 ,16 0 ,16 0 ,16 0 ,16 0 ,0 0 ,0 0 ,0 0 ,0 0 ,0 0 ,0 0 ,0 0 ,0 0 ,0 0 ,0 0 ,0 0 ,0 0 ,0 0 ,0 0 ,0 0 ,0 0 ,0 0 ,0 0 ,0 0 ,0 0 ,0 0 ,0 0 ,
2 0 ,2 0 ,2 0 ,2 0 ,2 0 ,2 0 ,2 0 ,2 0 ,2 0 ,2 0 ,2 0 ,2 0 ,2 0 ,2 0 ,21 0 ,21 0 ,16 0 ,16 0 ,16 0 ,16 0 ,16 0 ,16 0 ,16 0 ,16 0 ,16 0 ,16 0 ,16 0 ,39 0 ,40 0 ,40 0 ,41 0 ,16 0 ,16 0 ,16 0 ,16 0 ,16 0 ,16 0 ,16 0 ,16 0 ,16 0 ,16 0 ,16 0 ,0 0 ,0 0 ,0 0 ,0 0 ,0 0 ,0 0 ,0 0 ,0 0 ,0 0 ,0 0 ,0 0 ,0 0 ,0 0 ,0 0 ,0 0 ,0 0 ,0 0 ,0 0 ,0 0 ,0 0 ,0 0 ,0 0 ,
2 0 ,2 0 ,2 0 ,2 0 ,2 0 ,2 0 ,2 0 ,2 0 ,2 0 ,2 0 ,2 0 ,2 0 ,2 0 ,2 0 ,34 1 ,34 1 ,34 1 ,34 1 ,34 1 ,34 1 ,34 1 ,34 1 ,10 0 ,11 0 ,11 0 ,11 0 ,12 0 ,34 1 ,34 1 ,34 1 ,34 1 ,10 0 ,11 0 ,11 0 ,11 0 ,11 0 ,11 0 ,11 0 ,11 0 ,11 0 ,11 0 ,12 0 ,0 0 ,0 0 ,0 0 ,0 0 ,0 0 ,0 0 ,0 0 ,0 0 ,0 0 ,0 0 ,0 0 ,0 0 ,0 0 ,0 0 ,0 0 ,0 0 ,0 0 ,0 0 ,0 0 ,0 0 ,0 0 ,0 0 ,
2 0 ,2 0 ,2 0 ,2 0 ,2 0 ,2 0 ,2 0 ,2 0 ,2 0 ,2 0 ,2 0 ,2 0 ,2 0 ,2 0 ,17 0 ,17 0 ,17 0 ,17 0 ,17 0 ,17 0 ,17 0 ,17 0 ,17 0 ,17 0 ,17 0 ,17 0 ,17 0 ,17 0 ,17 0 ,17 0 ,17 0 ,17 0 ,17 0 ,17 0 ,17 0 ,17 0 ,17 0 ,17 0 ,17 0 ,17 0 ,17 0 ,17 0 ,0 0 ,0 0 ,0 0 ,0 0 ,0 0 ,0 0 ,0 0 ,0 0 ,0 0 ,0 0 ,0 0 ,0 0 ,0 0 ,0 0 ,0 0 ,0 0 ,0 0 ,0 0 ,0 0 ,0 0 ,0 0 ,0 0 ,
2 0 ,2 0 ,2 0 ,2 0 ,2 0 ,2 0 ,2 0 ,2 0 ,2 0 ,2 0 ,2 0 ,2 0 ,2 0 ,2 0 ,21 0 ,21 0 ,21 0 ,16 0 ,16 0 ,16 0 ,16 0 ,16 0 ,16 0 ,16 0 ,16 0 ,7 0 ,8 0 ,8 0 ,8 0 ,9 0 ,16 0 ,16 0 ,16 0 ,16 0 ,16 0 ,16 0 ,16 0 ,52 0 ,53 0 ,53 0 ,54 0 ,16 0 ,0 0 ,0 0 ,24 1 ,24 1 ,24 1 ,24 1 ,24 1 ,24 1 ,24 1 ,0 0 ,0 0 ,0 0 ,0 0 ,0 0 ,0 0 ,0 0 ,0 0 ,0 0 ,0 0 ,0 0 ,0 0 ,0 0 ,
2 0 ,2 0 ,2 0 ,2 0 ,2 0 ,2 0 ,2 0 ,2 0 ,2 0 ,2 0 ,2 0 ,2 0 ,2 0 ,2 0 ,21 0 ,21 0 ,21 0 ,16 0 ,16 0 ,16 0 ,16 0 ,16 0 ,16 0 ,16 0 ,16 0 ,23 0 ,24 0 ,24 0 ,24 0 ,25 0 ,16 0 ,16 0 ,16 0 ,16 0 ,16 0 ,16 0 ,16 0 ,68 0 ,0 0 ,0 0 ,70 0 ,16 0 ,0 0 ,0 0 ,24 1 ,24 1 ,24 1 ,24 1 ,24 1 ,24 1 ,24 1 ,0 0 ,0 0 ,0 0 ,0 0 ,0 0 ,0 0 ,0 0 ,0 0 ,0 0 ,0 0 ,0 0 ,0 0 ,0 0 ,
2 0 ,2 0 ,2 0 ,2 0 ,2 0 ,2 0 ,2 0 ,2 0 ,2 0 ,2 0 ,2 0 ,2 0 ,2 0 ,2 0 ,21 0 ,21 0 ,16 0 ,16 0 ,16 0 ,16 0 ,16 0 ,16 0 ,16 0 ,16 0 ,16 0 ,39 0 ,40 0 ,40 0 ,40 0 ,41 0 ,16 0 ,16 0 ,16 0 ,16 0 ,16 0 ,16 0 ,16 0 ,84 0 ,85 0 ,85 0 ,86 0 ,16 0 ,0 0 ,0 0 ,24 1 ,24 1 ,24 1 ,24 1 ,24 1 ,24 1 ,24 1 ,0 0 ,0 0 ,0 0 ,0 0 ,0 0 ,0 0 ,0 0 ,0 0 ,0 0 ,0 0 ,0 0 ,0 0 ,0 0 ,
2 0 ,2 0 ,2 0 ,2 0 ,2 0 ,2 0 ,2 0 ,2 0 ,2 0 ,2 0 ,2 0 ,2 0 ,2 0 ,2 0 ,34 1 ,34 1 ,34 1 ,34 1 ,34 1 ,34 1 ,10 0 ,11 0 ,11 0 ,11 0 ,12 0 ,34 1 ,34 1 ,34 1 ,34 1 ,34 1 ,10 0 ,11 0 ,11 0 ,11 0 ,11 0 ,11 0 ,12 0 ,34 1 ,34 1 ,34 1 ,34 1 ,34 1 ,0 0 ,0 0 ,24 1 ,24 1 ,24 1 ,24 1 ,0 0 ,24 1 ,24 1 ,0 0 ,0 0 ,0 0 ,0 0 ,0 0 ,0 0 ,0 0 ,0 0 ,0 0 ,0 0 ,0 0 ,0 0 ,0 0 ,
0 0 ,1 0 ,2 0 ,2 0 ,2 0 ,2 0 ,2 0 ,1 0 ,1 0 ,2 0 ,2 0 ,2 0 ,2 0 ,2 0 ,17 0 ,17 0 ,17 0 ,17 0 ,17 0 ,17 0 ,17 0 ,17 0 ,17 0 ,17 0 ,17 0 ,17 0 ,17 0 ,17 0 ,17 0 ,17 0 ,17 0 ,17 0 ,17 0 ,17 0 ,17 0 ,17 0 ,17 0 ,17 0 ,17 0 ,49 0 ,49 0 ,49 0 ,21 0 ,21 0 ,21 0 ,21 0 ,21 0 ,21 0 ,21 0 ,21 0 ,21 0 ,21 0 ,21 0 ,21 0 ,21 0 ,0 0 ,0 0 ,0 0 ,0 0 ,0 0 ,0 0 ,0 0 ,0 0 ,0 0 ,
0 0 ,1 0 ,1 0 ,1 0 ,1 0 ,1 0 ,1 0 ,1 0 ,1 0 ,2 0 ,2 0 ,2 0 ,2 0 ,2 0 ,21 0 ,21 0 ,21 0 ,21 0 ,16 0 ,16 0 ,16 0 ,16 0 ,16 0 ,16 0 ,142 1 ,16 0 ,16 0 ,16 0 ,142 1 ,16 0 ,16 0 ,16 0 ,16 0 ,16 0 ,16 0 ,16 0 ,16 0 ,16 0 ,16 0 ,21 0 ,21 0 ,21 0 ,21 0 ,21 0 ,21 0 ,21 0 ,21 0 ,21 0 ,21 0 ,21 0 ,21 0 ,21 0 ,21 0 ,21 0 ,21 0 ,0 0 ,0 0 ,0 0 ,0 0 ,0 0 ,0 0 ,0 0 ,0 0 ,0 0 ,
0 0 ,0 0 ,1 0 ,1 0 ,1 0 ,1 0 ,1 0 ,1 0 ,2 0 ,1 0 ,1 0 ,1 0 ,1 0 ,0 0 ,21 0 ,21 0 ,21 0 ,21 0 ,16 0 ,16 0 ,16 0 ,16 0 ,16 0 ,16 0 ,16 0 ,16 0 ,16 0 ,16 0 ,16 0 ,16 0 ,16 0 ,16 0 ,16 0 ,16 0 ,16 0 ,16 0 ,16 0 ,16 0 ,16 0 ,21 0 ,21 0 ,21 0 ,21 0 ,21 0 ,21 0 ,21 0 ,21 0 ,21 0 ,21 0 ,21 0 ,21 0 ,21 0 ,21 0 ,21 0 ,21 0 ,0 0 ,0 0 ,0 0 ,0 0 ,0 0 ,0 0 ,0 0 ,0 0 ,0 0 ,
0 0 ,0 0 ,1 0 ,1 0 ,1 0 ,1 0 ,1 0 ,1 0 ,2 0 ,2 0 ,1 0 ,1 0 ,1 0 ,1 0 ,21 0 ,21 0 ,21 0 ,21 0 ,16 0 ,16 0 ,16 0 ,16 0 ,142 1 ,16 0 ,16 0 ,16 0 ,143 1 ,16 0 ,16 0 ,16 0 ,142 1 ,16 0 ,16 0 ,16 0 ,16 0 ,16 0 ,16 0 ,16 0 ,16 0 ,21 0 ,21 0 ,21 0 ,21 0 ,21 0 ,21 0 ,21 0 ,21 0 ,21 0 ,21 0 ,21 0 ,21 0 ,21 0 ,21 0 ,21 0 ,21 0 ,0 0 ,0 0 ,0 0 ,0 0 ,0 0 ,0 0 ,0 0 ,0 0 ,0 0 ,
0 0 ,0 0 ,1 0 ,1 0 ,1 0 ,1 0 ,0 0 ,1 0 ,2 0 ,2 0 ,2 0 ,1 0 ,1 0 ,1 0 ,21 0 ,21 0 ,21 0 ,21 0 ,16 0 ,16 0 ,16 0 ,16 0 ,16 0 ,16 0 ,16 0 ,16 0 ,16 0 ,16 0 ,16 0 ,16 0 ,16 0 ,16 0 ,16 0 ,16 0 ,16 0 ,16 0 ,16 0 ,16 0 ,16 0 ,21 0 ,21 0 ,21 0 ,21 0 ,21 0 ,21 0 ,21 0 ,21 0 ,21 0 ,21 0 ,21 0 ,21 0 ,21 0 ,21 0 ,21 0 ,21 0 ,0 0 ,0 0 ,0 0 ,0 0 ,0 0 ,0 0 ,0 0 ,0 0 ,0 0 ,
0 0 ,0 0 ,0 0 ,0 0 ,0 0 ,0 0 ,0 0 ,1 0 ,1 0 ,1 0 ,2 0 ,1 0 ,1 0 ,1 0 ,21 0 ,21 0 ,21 0 ,21 0 ,16 0 ,16 0 ,16 0 ,16 0 ,16 0 ,16 0 ,142 1 ,16 0 ,16 0 ,16 0 ,142 1 ,16 0 ,16 0 ,16 0 ,16 0 ,16 0 ,16 0 ,16 0 ,16 0 ,16 0 ,16 0 ,21 0 ,21 0 ,21 0 ,21 0 ,21 0 ,21 0 ,21 0 ,21 0 ,21 0 ,21 0 ,21 0 ,21 0 ,21 0 ,21 0 ,21 0 ,21 0 ,0 0 ,0 0 ,0 0 ,0 0 ,0 0 ,0 0 ,0 0 ,0 0 ,0 0 ,
0 0 ,0 0 ,0 0 ,0 0 ,0 0 ,0 0 ,0 0 ,0 0 ,1 0 ,1 0 ,2 0 ,2 0 ,2 0 ,2 0 ,21 0 ,21 0 ,21 0 ,21 0 ,16 0 ,16 0 ,16 0 ,16 0 ,16 0 ,16 0 ,16 0 ,16 0 ,16 0 ,16 0 ,16 0 ,16 0 ,16 0 ,16 0 ,16 0 ,16 0 ,16 0 ,16 0 ,16 0 ,16 0 ,16 0 ,21 0 ,21 0 ,21 0 ,21 0 ,21 0 ,21 0 ,21 0 ,21 0 ,21 0 ,21 0 ,21 0 ,21 0 ,21 0 ,21 0 ,21 0 ,21 0 ,0 0 ,0 0 ,0 0 ,0 0 ,0 0 ,0 0 ,0 0 ,0 0 ,0 0 ,
