64 16
13 0 ,13 0 ,13 0 ,13 0 ,13 0 ,13 0 ,13 0 ,13 0 ,13 0 ,13 0 ,13 0 ,13 0 ,13 0 ,13 0 ,13 0 ,13 0 ,13 0 ,13 0 ,13 0 ,13 0 ,13 0 ,13 0 ,13 0 ,13 0 ,13 0 ,13 0 ,13 0 ,13 0 ,13 0 ,13 0 ,13 0 ,13 0 ,13 0 ,13 0 ,13 0 ,13 0 ,13 0 ,13 0 ,13 0 ,13 0 ,13 0 ,13 0 ,13 0 ,13 0 ,13 0 ,13 0 ,13 0 ,13 0 ,13 0 ,13 0 ,13 0 ,13 0 ,13 0 ,13 0 ,13 0 ,13 0 ,13 0 ,13 0 ,13 0 ,13 0 ,13 0 ,13 0 ,13 0 ,13 0 ,
13 0 ,13 0 ,13 0 ,13 0 ,13 0 ,13 0 ,13 0 ,13 0 ,13 0 ,13 0 ,13 0 ,13 0 ,13 0 ,13 0 ,13 0 ,13 0 ,13 0 ,13 0 ,13 0 ,13 0 ,13 0 ,13 0 ,13 0 ,13 0 ,13 0 ,13 0 ,13 0 ,13 0 ,13 0 ,13 0 ,13 0 ,13 0 ,13 0 ,13 0 ,13 0 ,13 0 ,13 0 ,13 0 ,13 0 ,13 0 ,13 0 ,13 0 ,13 0 ,13 0 ,13 0 ,13 0 ,13 0 ,13 0 ,13 0 ,13 0 ,13 0 ,13 0 ,13 0 ,13 0 ,13 0 ,13 0 ,13 0 ,13 0 ,13 0 ,13 0 ,13 0 ,13 0 ,13 0 ,13 0 ,
13 0 ,13 0 ,13 0 ,13 0 ,13 0 ,13 0 ,13 0 ,13 0 ,13 0 ,13 0 ,13 0 ,13 0 ,13 0 ,13 0 ,13 0 ,13 0 ,13 0 ,13 0 ,13 0 ,13 0 ,13 0 ,13 0 ,13 0 ,13 0 ,13 0 ,13 0 ,63 0 ,13 0 ,13 0 ,13 0 ,13 0 ,13 0 ,13 0 ,13 0 ,13 0 ,13 0 ,13 0 ,13 0 ,13 0 ,13 0 ,13 0 ,13 0 ,13 0 ,13 0 ,13 0 ,13 0 ,13 0 ,13 0 ,13 0 ,13 0 ,13 0 ,13 0 ,13 0 ,13 0 ,13 0 ,13 0 ,13 0 ,13 0 ,13 0 ,13 0 ,13 0 ,13 0 ,13 0 ,13 0 ,
13 0 ,13 0 ,13 0 ,13 0 ,13 0 ,13 0 ,13 0 ,13 0 ,13 0 ,13 0 ,13 0 ,13 0 ,13 0 ,13 0 ,13 0 ,13 0 ,13 1 ,13 1 ,13 1 ,13 1 ,13 1 ,13 1 ,13 1 ,13 0 ,13 0 ,13 0 ,79 1 ,13 1 ,13 1 ,13 1 ,13 1 ,13 1 ,13 0 ,13 0 ,13 0 ,13 0 ,13 0 ,13 0 ,13 0 ,13 0 ,13 0 ,13 1 ,13 0 ,13 0 ,13 0 ,13 0 ,13 0 ,13 0 ,13 0 ,13 0 ,13 0 ,13 0 ,13 0 ,13 0 ,13 0 ,13 0 ,13 0 ,13 0 ,13 0 ,13 0 ,13 0 ,13 0 ,13 0 ,13 0 ,
13 0 ,13 0 ,13 0 ,13 0 ,13 0 ,13 0 ,13 0 ,13 0 ,13 0 ,13 0 ,13 0 ,13 0 ,13 0 ,13 0 ,13 0 ,13 0 ,13 0 ,13 0 ,13 0 ,13 0 ,13 0 ,13 0 ,78 0 ,78 0 ,13 0 ,13 0 ,111 0 ,13 0 ,13 0 ,13 0 ,13 0 ,13 0 ,13 0 ,13 0 ,13 0 ,13 0 ,13 0 ,13 0 ,13 0 ,13 0 ,13 0 ,13 0 ,13 0 ,13 0 ,13 0 ,13 0 ,13 0 ,13 0 ,13 0 ,13 0 ,13 0 ,13 0 ,13 0 ,13 0 ,13 0 ,13 0 ,13 0 ,13 0 ,13 0 ,13 0 ,13 0 ,13 0 ,13 0 ,13 0 ,
13 0 ,13 0 ,13 0 ,13 0 ,13 0 ,13 0 ,13 0 ,13 0 ,13 0 ,13 0 ,13 0 ,13 0 ,13 0 ,13 0 ,13 0 ,13 0 ,13 0 ,13 0 ,13 0 ,13 0 ,13 0 ,13 0 ,13 0 ,13 0 ,13 0 ,13 0 ,95 0 ,13 0 ,13 0 ,13 0 ,13 0 ,13 0 ,13 0 ,13 0 ,13 0 ,13 0 ,13 0 ,13 0 ,13 0 ,13 0 ,13 0 ,13 0 ,13 0 ,13 0 ,13 0 ,13 0 ,13 0 ,13 0 ,13 0 ,13 0 ,13 0 ,13 0 ,13 0 ,13 0 ,13 0 ,13 0 ,13 0 ,13 0 ,13 0 ,13 0 ,13 0 ,13 0 ,13 0 ,13 0 ,
13 0 ,13 0 ,13 0 ,13 0 ,13 0 ,13 0 ,13 0 ,13 0 ,13 0 ,13 0 ,13 0 ,13 0 ,13 0 ,13 0 ,13 0 ,13 0 ,13 0 ,13 0 ,13 0 ,13 0 ,13 0 ,13 0 ,13 0 ,13 0 ,13 0 ,13 0 ,111 0 ,13 0 ,13 0 ,13 0 ,13 0 ,13 0 ,13 0 ,13 0 ,13 0 ,13 0 ,13 0 ,13 0 ,13 0 ,13 0 ,13 0 ,13 0 ,13 0 ,13 0 ,13 0 ,13 0 ,13 0 ,13 0 ,13 0 ,13 0 ,13 0 ,13 0 ,13 0 ,13 0 ,13 0 ,13 0 ,13 0 ,13 0 ,13 0 ,13 0 ,13 0 ,13 0 ,13 0 ,13 0 ,
13 0 ,13 0 ,13 0 ,13 0 ,13 0 ,13 0 ,13 0 ,13 0 ,13 0 ,13 0 ,13 0 ,13 0 ,13 0 ,13 0 ,13 0 ,13 0 ,13 0 ,13 0 ,13 0 ,13 0 ,13 0 ,13 0 ,78 0 ,78 0 ,78 0 ,13 0 ,95 0 ,13 0 ,13 0 ,13 0 ,13 0 ,13 0 ,13 0 ,13 0 ,13 0 ,13 0 ,13 0 ,13 0 ,13 0 ,13 0 ,13 0 ,13 0 ,13 0 ,13 0 ,13 0 ,13 0 ,13 0 ,13 0 ,13 0 ,13 0 ,13 0 ,13 0 ,13 0 ,13 0 ,13 0 ,13 0 ,13 0 ,13 0 ,13 0 ,13 0 ,13 0 ,13 0 ,13 0 ,13 0 ,
13 0 ,13 0 ,13 0 ,13 0 ,13 0 ,13 0 ,13 0 ,13 0 ,13 0 ,13 0 ,13 0 ,13 0 ,13 0 ,13 0 ,13 0 ,13 0 ,13 1 ,13 1 ,13 1 ,13 1 ,13 1 ,13 0 ,13 0 ,13 0 ,13 1 ,13 1 ,111 1 ,13 1 ,13 1 ,13 1 ,13 1 ,13 0 ,13 0 ,13 0 ,13 0 ,13 0 ,13 1 ,13 1 ,13 1 ,13 1 ,13 1 ,13 1 ,13 0 ,13 0 ,13 0 ,13 0 ,13 0 ,13 0 ,13 0 ,13 0 ,13 0 ,13 0 ,13 0 ,13 0 ,13 0 ,13 0 ,13 0 ,13 0 ,13 0 ,13 0 ,13 0 ,13 0 ,13 0 ,13 0 ,
13 0 ,13 0 ,13 0 ,13 0 ,13 0 ,13 0 ,13 0 ,13 0 ,13 0 ,13 0 ,13 0 ,13 0 ,13 0 ,13 0 ,13 0 ,13 0 ,13 0 ,13 0 ,13 0 ,13 0 ,13 0 ,13 0 ,13 0 ,13 0 ,13 0 ,13 0 ,95 0 ,13 0 ,13 0 ,13 0 ,13 0 ,13 0 ,13 0 ,13 0 ,13 0 ,13 0 ,13 0 ,13 0 ,13 0 ,13 0 ,13 0 ,13 0 ,13 0 ,13 0 ,13 0 ,13 0 ,13 0 ,13 0 ,13 0 ,13 0 ,13 0 ,13 0 ,13 0 ,13 0 ,13 0 ,13 0 ,13 0 ,13 0 ,13 0 ,13 0 ,13 0 ,13 0 ,13 0 ,13 0 ,
13 0 ,13 0 ,13 0 ,13 0 ,13 0 ,13 0 ,13 0 ,13 0 ,13 0 ,13 0 ,13 0 ,13 0 ,13 0 ,13 0 ,13 0 ,13 0 ,13 0 ,13 0 ,13 0 ,13 0 ,13 0 ,13 0 ,13 0 ,13 0 ,13 1 ,13 0 ,111 0 ,13 0 ,13 1 ,13 0 ,13 0 ,13 0 ,13 0 ,13 0 ,13 0 ,13 0 ,13 0 ,13 0 ,13 0 ,13 0 ,13 0 ,13 0 ,13 0 ,13 0 ,13 0 ,13 0 ,13 0 ,13 0 ,13 0 ,13 0 ,13 0 ,13 0 ,13 0 ,13 0 ,13 0 ,13 0 ,13 0 ,13 0 ,13 0 ,13 0 ,13 0 ,13 0 ,13 0 ,13 0 ,
13 0 ,13 0 ,13 0 ,13 0 ,13 0 ,13 0 ,13 0 ,13 0 ,13 0 ,13 0 ,13 0 ,13 0 ,13 0 ,13 0 ,13 0 ,13 0 ,13 0 ,13 0 ,13 0 ,13 0 ,13 0 ,13 0 ,13 0 ,13 0 ,13 0 ,13 0 ,127 0 ,13 0 ,13 0 ,13 0 ,13 0 ,13 0 ,13 0 ,13 0 ,13 0 ,13 0 ,13 0 ,13 0 ,13 0 ,13 0 ,13 0 ,13 0 ,13 0 ,13 0 ,13 0 ,13 0 ,13 0 ,13 0 ,13 0 ,13 0 ,13 0 ,13 0 ,13 0 ,13 0 ,13 0 ,13 0 ,13 0 ,13 0 ,13 0 ,13 0 ,13 0 ,13 0 ,13 0 ,13 0 ,
13 0 ,13 0 ,13 0 ,13 0 ,13 0 ,13 0 ,13 0 ,13 0 ,13 0 ,13 0 ,13 0 ,13 0 ,13 0 ,13 0 ,13 0 ,13 0 ,13 0 ,13 0 ,13 0 ,13 0 ,13 0 ,13 0 ,13 1 ,13 0 ,13 0 ,13 0 ,141 1 ,13 0 ,13 0 ,13 0 ,13 1 ,13 0 ,13 0 ,13 0 ,13 0 ,13 0 ,13 0 ,13 0 ,13 0 ,13 0 ,13 0 ,13 0 ,13 0 ,13 0 ,13 0 ,13 0 ,13 0 ,13 0 ,13 0 ,13 0 ,13 0 ,13 0 ,13 0 ,13 0 ,13 0 ,13 0 ,13 0 ,13 0 ,13 0 ,13 0 ,13 0 ,13 0 ,13 0 ,13 0 ,
13 0 ,13 0 ,13 0 ,13 0 ,13 0 ,13 0 ,13 0 ,13 0 ,13 0 ,13 0 ,13 0 ,13 0 ,13 0 ,13 0 ,13 0 ,13 0 ,13 0 ,13 0 ,13 0 ,13 0 ,13 0 ,13 0 ,13 0 ,13 0 ,13 0 ,13 0 ,13 0 ,13 0 ,13 0 ,13 0 ,13 0 ,13 0 ,13 0 ,13 0 ,13 0 ,13 0 ,13 0 ,13 0 ,13 0 ,13 0 ,13 0 ,13 0 ,13 0 ,13 0 ,13 0 ,13 0 ,13 0 ,13 0 ,13 0 ,13 0 ,13 0 ,13 0 ,13 0 ,13 0 ,13 0 ,13 0 ,13 0 ,13 0 ,13 0 ,13 0 ,13 0 ,13 0 ,13 0 ,13 0 ,
13 0 ,13 0 ,13 0 ,13 0 ,13 0 ,13 0 ,13 0 ,13 0 ,13 0 ,13 0 ,13 0 ,13 0 ,13 0 ,13 0 ,13 0 ,13 0 ,13 0 ,13 0 ,13 0 ,13 0 ,13 0 ,13 0 ,13 0 ,13 0 ,13 1 ,13 0 ,13 0 ,13 0 ,13 1 ,13 0 ,13 0 ,13 0 ,13 0 ,13 0 ,13 0 ,13 0 ,13 0 ,13 0 ,13 0 ,13 0 ,13 0 ,13 0 ,13 0 ,13 0 ,13 0 ,13 0 ,13 0 ,13 0 ,13 0 ,13 0 ,13 0 ,13 0 ,13 0 ,13 0 ,13 0 ,13 0 ,13 0 ,13 0 ,13 0 ,13 0 ,13 0 ,13 0 ,13 0 ,13 0 ,
13 0 ,13 0 ,13 0 ,13 0 ,13 0 ,13 0 ,13 0 ,13 0 ,13 0 ,13 0 ,13 0 ,13 0 ,13 0 ,13 0 ,13 0 ,13 0 ,13 0 ,13 0 ,13 0 ,13 0 ,13 0 ,13 0 ,13 0 ,13 0 ,13 0 ,13 0 ,13 0 ,13 0 ,13 0 ,13 0 ,13 0 ,13 0 ,13 0 ,13 0 ,13 0 ,13 0 ,13 0 ,13 0 ,13 0 ,13 0 ,13 0 ,13 0 ,13 0 ,13 0 ,13 0 ,13 0 ,13 0 ,13 0 ,13 0 ,13 0 ,13 0 ,13 0 ,13 0 ,13 0 ,13 0 ,13 0 ,13 0 ,13 0 ,13 0 ,13 0 ,13 0 ,13 0 ,13 0 ,13 0 ,
