64 16
24 0 ,24 0 ,24 0 ,24 0 ,24 0 ,24 0 ,24 0 ,24 0 ,24 0 ,24 0 ,24 0 ,24 0 ,24 0 ,24 0 ,24 0 ,24 0 ,24 0 ,24 0 ,24 0 ,24 0 ,24 0 ,24 0 ,24 0 ,24 0 ,24 0 ,24 0 ,24 0 ,24 0 ,24 0 ,24 0 ,24 0 ,24 0 ,24 0 ,24 0 ,24 0 ,24 0 ,24 0 ,24 0 ,24 0 ,24 0 ,24 0 ,24 0 ,24 0 ,24 0 ,24 0 ,24 0 ,24 0 ,24 0 ,24 0 ,24 0 ,24 0 ,24 0 ,24 0 ,24 0 ,24 0 ,24 0 ,24 0 ,24 0 ,24 0 ,24 0 ,24 0 ,24 0 ,24 0 ,24 0 ,
24 0 ,24 0 ,24 0 ,24 0 ,24 0 ,24 0 ,24 0 ,24 0 ,24 0 ,24 0 ,24 0 ,24 0 ,24 0 ,24 0 ,24 0 ,24 0 ,24 0 ,24 0 ,24 0 ,24 0 ,24 0 ,24 0 ,24 0 ,24 0 ,24 0 ,24 0 ,24 0 ,24 0 ,24 0 ,24 0 ,24 0 ,24 0 ,24 0 ,24 0 ,24 0 ,24 0 ,24 0 ,24 0 ,24 0 ,24 0 ,24 0 ,24 0 ,24 0 ,24 0 ,24 0 ,24 0 ,24 0 ,24 0 ,24 0 ,24 0 ,24 0 ,24 0 ,24 0 ,24 0 ,24 0 ,24 0 ,24 0 ,24 0 ,24 0 ,24 0 ,24 0 ,24 0 ,24 0 ,24 0 ,
24 0 ,24 0 ,24 0 ,24 0 ,24 0 ,24 0 ,24 0 ,24 0 ,24 0 ,24 0 ,24 0 ,24 0 ,24 0 ,24 0 ,24 0 ,24 0 ,24 0 ,24 0 ,24 0 ,24 0 ,24 0 ,24 0 ,24 0 ,24 0 ,24 0 ,24 0 ,24 0 ,24 0 ,24 0 ,24 0 ,24 0 ,24 0 ,24 0 ,24 0 ,24 0 ,24 0 ,24 0 ,24 0 ,24 0 ,24 0 ,24 0 ,24 0 ,24 0 ,24 0 ,24 0 ,24 0 ,24 0 ,24 0 ,24 0 ,24 0 ,24 0 ,24 0 ,24 0 ,24 0 ,24 0 ,24 0 ,24 0 ,24 0 ,24 0 ,24 0 ,24 0 ,24 0 ,24 0 ,24 0 ,
24 0 ,24 0 ,24 0 ,24 0 ,24 0 ,24 0 ,24 0 ,24 0 ,24 0 ,24 0 ,24 0 ,24 0 ,24 0 ,24 0 ,24 0 ,24 0 ,24 0 ,24 0 ,24 0 ,24 0 ,24 0 ,24 0 ,24 0 ,24 0 ,24 0 ,24 0 ,24 0 ,24 1 ,24 1 ,24 1 ,24 1 ,24 1 ,24 1 ,24 1 ,24 1 ,24 1 ,24 1 ,24 1 ,24 1 ,24 1 ,24 1 ,24 0 ,24 0 ,24 0 ,24 0 ,24 0 ,24 0 ,24 0 ,24 0 ,24 0 ,24 0 ,24 0 ,24 0 ,24 0 ,24 0 ,24 0 ,24 0 ,24 0 ,24 0 ,24 0 ,24 0 ,24 0 ,24 0 ,24 0 ,
24 0 ,24 0 ,24 0 ,24 0 ,24 0 ,24 0 ,24 0 ,24 0 ,24 0 ,24 0 ,24 0 ,24 0 ,24 0 ,24 0 ,24 0 ,24 0 ,24 0 ,24 0 ,24 0 ,24 0 ,24 0 ,24 0 ,24 0 ,24 0 ,24 0 ,24 0 ,24 0 ,24 1 ,4 0 ,5 0 ,5 0 ,5 0 ,5 0 ,5 0 ,5 0 ,5 0 ,5 0 ,5 0 ,5 0 ,6 0 ,24 1 ,24 0 ,24 0 ,24 0 ,24 0 ,24 0 ,24 0 ,24 0 ,24 0 ,24 0 ,24 0 ,24 0 ,24 0 ,24 0 ,24 0 ,24 0 ,24 0 ,24 0 ,24 0 ,24 0 ,24 0 ,24 0 ,24 0 ,24 0 ,
24 0 ,24 0 ,24 0 ,24 0 ,24 0 ,24 0 ,24 0 ,24 0 ,24 0 ,24 0 ,24 0 ,24 0 ,24 0 ,24 0 ,24 0 ,24 0 ,24 0 ,24 0 ,24 0 ,24 0 ,24 0 ,24 0 ,24 0 ,24 0 ,24 0 ,24 0 ,24 0 ,24 1 ,20 0 ,16 0 ,16 0 ,16 0 ,16 0 ,16 0 ,16 0 ,16 0 ,16 0 ,16 0 ,16 0 ,22 0 ,24 1 ,24 0 ,24 0 ,24 0 ,24 0 ,24 0 ,24 0 ,24 0 ,24 0 ,24 0 ,24 0 ,24 0 ,24 0 ,24 0 ,24 0 ,24 0 ,24 0 ,24 0 ,24 0 ,24 0 ,24 0 ,24 0 ,24 0 ,24 0 ,
24 0 ,24 0 ,24 0 ,24 0 ,24 0 ,24 0 ,24 0 ,24 0 ,24 0 ,24 0 ,24 0 ,24 0 ,24 0 ,24 0 ,24 0 ,24 0 ,24 0 ,24 0 ,24 0 ,24 0 ,24 0 ,24 0 ,24 0 ,24 0 ,24 0 ,24 0 ,24 0 ,24 1 ,20 0 ,16 0 ,16 0 ,16 0 ,16 0 ,16 0 ,16 0 ,16 0 ,16 0 ,16 0 ,16 0 ,22 0 ,24 1 ,24 0 ,24 0 ,24 0 ,24 0 ,24 0 ,24 0 ,24 0 ,24 0 ,24 0 ,24 0 ,24 0 ,24 0 ,24 0 ,24 0 ,24 0 ,24 0 ,24 0 ,24 0 ,24 0 ,24 0 ,24 0 ,24 0 ,24 0 ,
24 0 ,24 0 ,24 0 ,24 0 ,24 0 ,24 0 ,24 0 ,24 0 ,24 0 ,24 0 ,24 0 ,24 0 ,24 0 ,24 0 ,24 0 ,24 0 ,24 0 ,24 0 ,24 0 ,24 0 ,24 0 ,24 0 ,24 0 ,24 0 ,24 0 ,24 0 ,24 0 ,24 1 ,20 0 ,16 0 ,16 0 ,16 0 ,16 0 ,16 0 ,16 0 ,16 0 ,16 0 ,16 0 ,16 0 ,22 0 ,24 1 ,24 0 ,24 0 ,24 0 ,24 0 ,24 0 ,24 0 ,24 0 ,24 0 ,24 0 ,24 0 ,24 0 ,24 0 ,24 0 ,24 0 ,24 0 ,24 0 ,24 0 ,24 0 ,24 0 ,24 0 ,24 0 ,24 0 ,24 0 ,
24 0 ,24 0 ,24 0 ,24 0 ,24 0 ,24 0 ,24 0 ,24 0 ,24 0 ,24 0 ,24 0 ,24 0 ,24 0 ,24 0 ,24 0 ,24 0 ,24 0 ,24 0 ,24 0 ,24 0 ,24 0 ,24 0 ,24 0 ,24 0 ,24 0 ,24 0 ,24 0 ,24 1 ,20 0 ,21 0 ,16 0 ,16 0 ,16 0 ,16 0 ,16 0 ,16 0 ,16 0 ,16 0 ,16 0 ,22 0 ,24 1 ,24 0 ,24 0 ,24 0 ,24 0 ,24 0 ,24 0 ,24 0 ,24 0 ,24 0 ,24 0 ,24 0 ,24 0 ,24 0 ,24 0 ,24 0 ,24 0 ,24 0 ,24 0 ,24 0 ,24 0 ,24 0 ,24 0 ,24 0 ,
24 0 ,24 0 ,24 0 ,24 0 ,24 0 ,24 0 ,24 0 ,24 0 ,24 0 ,24 0 ,24 0 ,24 0 ,24 0 ,24 0 ,24 0 ,24 0 ,24 0 ,24 0 ,24 0 ,24 0 ,24 0 ,24 0 ,24 0 ,24 0 ,24 0 ,24 0 ,24 0 ,24 1 ,20 0 ,21 0 ,16 0 ,16 0 ,16 0 ,16 0 ,16 0 ,16 0 ,16 0 ,16 0 ,16 0 ,22 0 ,24 1 ,24 0 ,24 0 ,24 0 ,24 0 ,24 0 ,24 0 ,24 0 ,24 0 ,24 0 ,24 0 ,24 0 ,24 0 ,24 0 ,24 0 ,24 0 ,24 0 ,24 0 ,24 0 ,24 0 ,24 0 ,24 0 ,24 0 ,24 0 ,
24 0 ,24 0 ,24 0 ,24 0 ,24 0 ,24 0 ,24 0 ,24 0 ,24 0 ,24 0 ,24 0 ,24 0 ,24 0 ,24 0 ,24 0 ,24 0 ,24 0 ,24 0 ,24 0 ,24 0 ,24 0 ,24 0 ,24 0 ,24 0 ,24 0 ,24 0 ,24 0 ,24 1 ,20 0 ,16 0 ,16 0 ,16 0 ,16 0 ,16 0 ,16 0 ,16 0 ,16 0 ,16 0 ,16 0 ,22 0 ,24 1 ,24 0 ,24 0 ,24 0 ,24 0 ,24 0 ,24 0 ,24 0 ,24 0 ,24 0 ,24 0 ,24 0 ,24 0 ,24 0 ,24 0 ,24 0 ,24 0 ,24 0 ,24 0 ,24 0 ,24 0 ,24 0 ,24 0 ,24 0 ,
24 0 ,24 0 ,24 0 ,24 0 ,24 0 ,24 0 ,24 0 ,24 0 ,24 0 ,24 0 ,24 0 ,24 0 ,24 0 ,24 0 ,24 0 ,24 0 ,24 0 ,24 0 ,24 0 ,24 0 ,24 0 ,24 0 ,24 0 ,24 0 ,24 0 ,24 0 ,24 0 ,24 1 ,20 0 ,16 0 ,16 0 ,16 0 ,16 0 ,16 0 ,16 0 ,16 0 ,16 0 ,16 0 ,16 0 ,22 0 ,24 1 ,24 0 ,24 0 ,24 0 ,24 0 ,24 0 ,24 0 ,24 0 ,24 0 ,24 0 ,24 0 ,24 0 ,24 0 ,24 0 ,24 0 ,24 0 ,24 0 ,24 0 ,24 0 ,24 0 ,24 0 ,24 0 ,24 0 ,24 0 ,
24 0 ,24 0 ,24 0 ,24 0 ,24 0 ,24 0 ,24 0 ,24 0 ,24 0 ,24 0 ,24 0 ,24 0 ,24 0 ,24 0 ,24 0 ,24 0 ,24 0 ,24 0 ,24 0 ,24 0 ,24 0 ,24 0 ,24 0 ,24 0 ,24 0 ,24 0 ,24 0 ,24 0 ,36 0 ,37 0 ,37 0 ,21 0 ,21 0 ,21 0 ,21 0 ,21 0 ,37 0 ,37 0 ,37 0 ,38 0 ,24 1 ,24 0 ,24 0 ,24 0 ,24 0 ,24 0 ,24 0 ,24 0 ,24 0 ,24 0 ,24 0 ,24 0 ,24 0 ,24 0 ,24 0 ,24 0 ,24 0 ,24 0 ,24 0 ,24 0 ,24 0 ,24 0 ,24 0 ,24 0 ,
24 0 ,24 0 ,24 0 ,24 0 ,24 0 ,24 0 ,24 0 ,24 0 ,24 0 ,24 0 ,24 0 ,24 0 ,24 0 ,24 0 ,24 0 ,24 0 ,24 0 ,24 0 ,24 0 ,24 0 ,24 0 ,24 0 ,24 0 ,24 0 ,24 0 ,24 0 ,24 0 ,24 1 ,24 1 ,24 1 ,24 1 ,36 0 ,37 0 ,1 0 ,37 0 ,38 0 ,24 1 ,24 1 ,24 1 ,24 1 ,24 1 ,24 0 ,24 0 ,24 0 ,24 0 ,24 0 ,24 0 ,24 0 ,24 0 ,24 0 ,24 0 ,24 0 ,24 0 ,24 0 ,24 0 ,24 0 ,24 0 ,24 0 ,24 0 ,24 0 ,24 0 ,24 0 ,24 0 ,24 0 ,
24 0 ,24 0 ,24 0 ,24 0 ,24 0 ,24 0 ,24 0 ,24 0 ,24 0 ,24 0 ,24 0 ,24 0 ,24 0 ,24 0 ,24 0 ,24 0 ,24 0 ,24 0 ,24 0 ,24 0 ,24 0 ,24 0 ,24 0 ,24 0 ,24 0 ,24 0 ,24 0 ,24 0 ,24 0 ,24 0 ,24 1 ,24 1 ,24 1 ,1 0 ,24 1 ,24 1 ,24 1 ,24 0 ,24 0 ,24 0 ,24 0 ,24 0 ,24 0 ,24 0 ,24 0 ,24 0 ,24 0 ,24 0 ,24 0 ,24 0 ,24 0 ,24 0 ,24 0 ,24 0 ,24 0 ,24 0 ,24 0 ,24 0 ,24 0 ,24 0 ,24 0 ,24 0 ,24 0 ,24 0 ,
24 0 ,24 0 ,24 0 ,24 0 ,24 0 ,24 0 ,24 0 ,24 0 ,24 0 ,24 0 ,24 0 ,24 0 ,24 0 ,24 0 ,24 0 ,24 0 ,24 0 ,24 0 ,24 0 ,24 0 ,24 0 ,24 0 ,24 0 ,24 0 ,24 0 ,24 0 ,24 0 ,24 0 ,24 0 ,24 0 ,24 0 ,24 0 ,24 1 ,24 1 ,24 1 ,24 0 ,24 0 ,24 0 ,24 0 ,24 0 ,24 0 ,24 0 ,24 0 ,24 0 ,24 0 ,24 0 ,24 0 ,24 0 ,24 0 ,24 0 ,24 0 ,24 0 ,24 0 ,24 0 ,24 0 ,24 0 ,24 0 ,24 0 ,24 0 ,24 0 ,24 0 ,24 0 ,24 0 ,24 0 ,
